++++++++++++++++++++++
+      ++ ++          
+    +      + ++++++++
+ +  + ++   + +++++ ++
+ +++++ +++   +      +
+          ++++ +  + +
+++++ + +       + S+ +
+++++ +++  + +  ++   +
+          + +  + ++ +
+++++ +  + + +       +
++++++++++++++++++++++